111111111111
100000000001
100000000001
10000000N001
100000000001
100000000001
111111111111